11111111111111111111111
1 0 0 0 1 0 0 0 0 0 0 1
S 0 1 0 1 0 1111111 0 1
11111 0 1 0 0 0 0 1 0 1
1 0 0 0 0 11111 0 1 0 E
1111111 0 1 0 1 0 1 0 1
1 0 0 1 0 1 0 1 0 1 0 1
111 0 1 0 1 0 1 0 1 0 1
1 0 0 0 0 0 0 0 0 1 0 1
11111111111 0 1111110 1
1 0 0 0 0 0 0 1 0 0 0 1
11111111111111111111111